1,1,1,1,1,1,1,1,1,1,1,1,1,1,1,1,1,1,1,1,1,1,1,1
1,0,0,0,0,0,0,0,1,0,1,0,0,0,0,0,1,0,1,0,0,0,0,1
1,0,0,0,0,0,0,0,1,0,1,0,0,0,5,0,1,0,1,0,4,0,0,1
1,0,0,0,0,0,0,0,1,0,1,0,2,0,0,0,1,0,1,0,2,0,5,1
1,0,0,0,0,0,0,0,1,0,1,0,0,0,0,0,1,0,1,0,0,1,1,1
1,0,0,0,0,0,0,0,1,0,1,0,0,0,0,0,1,0,1,0,0,1,1,1
1,5,5,5,0,0,1,0,0,0,1,0,0,0,0,0,1,0,1,0,0,1,0,1
1,1,1,1,0,1,1,0,0,0,1,0,0,0,0,0,1,0,1,8,0,1,0,1
1,0,0,0,0,0,0,0,0,0,1,0,0,0,0,0,1,0,1,0,0,1,0,1
1,0,0,0,0,0,0,0,0,0,1,0,0,0,0,0,1,0,1,1,1,1,0,1
1,0,0,0,0,0,0,0,0,0,1,0,0,0,6,0,1,0,0,0,0,0,9,1
1,1,1,1,1,1,1,1,0,0,1,0,0,0,0,0,1,0,0,0,0,0,9,1
1,0,0,0,0,0,0,1,0,0,1,1,1,0,1,1,1,0,0,0,0,0,9,1
1,0,0,0,0,0,0,1,0,0,0,0,0,0,0,0,0,0,0,0,0,5,0,1
1,0,0,0,0,0,0,0,0,0,0,0,0,0,0,0,1,1,1,1,1,0,1,1
1,0,0,0,0,0,0,1,0,1,1,1,0,1,1,0,1,5,0,0,0,0,0,1
1,0,0,0,0,0,0,1,0,1,0,0,0,0,1,0,1,0,0,0,0,0,0,1
1,0,0,0,0,0,0,1,0,1,0,0,0,0,1,0,1,0,0,0,0,0,0,1
1,0,2,0,0,0,0,1,0,1,0,0,0,0,1,0,1,0,0,0,0,0,0,1
1,0,0,0,0,0,0,1,0,1,0,0,2,0,1,0,1,0,0,0,0,0,0,1
1,0,0,0,0,0,0,1,0,1,0,0,0,0,1,0,1,0,0,0,0,6,0,1
1,0,0,0,0,0,0,1,0,1,0,0,0,0,1,0,1,0,0,0,0,0,0,1
1,0,0,0,0,0,5,1,0,1,6,0,0,0,1,0,1,0,0,0,0,0,0,1
1,1,1,1,1,1,1,1,1,1,1,1,1,1,1,1,1,1,1,1,1,1,1,1
