1,1,1,1,1,1,1,1,1,1,1,1,1,1,1,1,1,1,1,1,1,1,1,1
1,0,1,0,0,0,0,1,0,1,0,0,0,0,0,0,0,0,1,0,1,0,0,1
1,0,0,6,0,0,0,1,0,1,0,0,0,0,0,0,0,0,1,0,1,0,5,1
1,0,1,0,0,0,0,1,0,1,0,0,0,0,0,0,0,8,1,0,1,0,5,1
1,0,1,0,2,0,0,1,0,1,1,1,1,1,0,1,1,1,1,0,1,0,0,1
1,0,1,0,0,0,0,1,0,0,0,0,0,0,0,0,0,0,0,0,1,0,0,1
1,0,1,0,0,0,5,1,0,0,0,0,0,0,0,0,0,0,1,1,1,0,0,1
1,0,1,0,0,0,0,1,0,0,1,1,1,1,1,0,1,0,1,0,0,0,2,1
1,0,1,1,1,1,1,1,0,0,1,0,0,0,0,0,1,0,1,5,0,0,0,1
1,0,0,0,0,0,0,0,0,0,1,0,0,0,0,0,1,0,1,0,0,0,0,1
1,0,0,0,0,0,0,0,0,0,1,0,0,0,0,0,1,0,1,1,1,0,1,1
1,1,1,1,0,0,0,0,0,0,1,0,0,0,0,0,1,0,0,0,0,0,9,1
1,0,6,1,0,0,0,0,0,0,1,0,0,0,0,0,1,0,0,0,0,0,9,1
1,0,0,1,0,0,0,0,0,0,1,0,0,0,0,0,1,0,0,0,0,0,9,1
1,0,0,1,3,0,0,0,0,5,1,0,0,0,0,0,1,0,1,1,1,1,1,1
1,0,0,1,1,1,0,1,1,1,1,0,0,0,0,0,1,0,1,0,0,0,0,1
1,0,0,0,0,1,0,1,0,0,0,0,5,0,0,0,1,0,1,0,0,0,0,1
1,0,0,0,0,1,0,1,0,0,0,0,0,0,0,0,1,0,1,0,0,0,0,1
1,0,2,0,0,1,0,1,0,0,0,0,0,0,0,0,1,0,1,0,0,2,0,1
1,0,0,0,0,1,0,1,0,6,0,0,0,0,2,0,1,0,1,0,0,0,0,1
1,0,0,0,0,1,0,1,0,0,0,0,0,0,0,0,1,0,1,0,0,5,0,1
1,5,0,0,0,0,0,1,0,0,0,0,0,0,0,0,1,0,1,0,0,0,0,1
1,0,0,0,0,1,0,1,0,0,0,0,0,0,0,0,1,0,1,4,0,0,0,1
1,1,1,1,1,1,1,1,1,1,1,1,1,1,1,1,1,1,1,1,1,1,1,1